%%%%%%%%%%%%%%%%
%....#$!!!!!***%
%....#$....##**%
%..#..#.....!!!%
%!**..!#.......%
%!*!!!!.##!!#**%
%...#$.......##%
%...$#$.....#..%
%...$#$....#$..%
%!!!.$#...#$...%
%........#$....%
%.$$##!!!$#$!#!%
%.##$$.@.......%
%%%%%%%%%%%%%%%%