%%%%%%%%%%%%%%%%
%..............%
%..............%
%..............%
%..............%
%..............%
%..............%
%..............%
%..............%
%..............%
%..............%
%..............%
%......@.......%
%%%%%%%%%%%%%%%%