%%%%%%%%%%%%%%%%
%33333333333333%
%33333333333333%
%33333333333333%
%33333333333333%
%33333333333333%
%33333333333333%
%33333333333333%
%33333333333333%
%33333333333333%
%33333333333333%
%33333333333333%
%333333@3333333%
%%%%%%%%%%%%%%%%