%%%%%%%%%%%%%%%%
%....#$!!!!!...%
%....#$....##..%
%..#..#.....!!!%
%!**..!#.......%
%!!!!!.##!!#**%
%...#$.......##%
%...$#$.....#..%
%...$#$....#$..%
%!!!.$#...#$...%
%........#$....%
%.$$##!!!$#$!#!%
%.##$$.@.......%
%%%%%%%%%%%%%%%%