%%%%%%%%%%%%%%%%
%*#**22&..&#...%
%....!!!....&#.%
%.#...???...?#.%
%.&...&#!....&#%
%!?!**!&#!***!!%
%2..&.......2..%
%.2.?.#&...2???%
%...#&....2....%
%.#&....&#..??.%
%#&.......#&#..%
%...........&#.%
%......@.....&#%
%%%%%%%%%%%%%%%%