%%%%%%%%%%%%%%%%
%....#......#..%
%....#.....#...%
%..#..#....#...%
%..............%
%...#$#........%
%...$#$......##%
%...$#$.....#..%
%...$#$....#...%
%...#$#...#$...%
%..$#$...#$....%
%..$#....$#$...%
%.##$..@.......%
%%%%%%%%%%%%%%%%