%%%%%%%%%%%%%%%%
%!**!##!**!*#..%
%.##.......#...%
%..##.....#....%
%...###....##..%
%.....##.....#.%
%!!!**!!!!!!#!!%
%!!###!!!!***&!%
%..&...........%
%....#!!#&****!%
%..!*.&..##....%
%!!!#......#...%
%**#...@.......%
%%%%%%%%%%%%%%%%