%%%%%%%%%%%%%%%%
%...........#..%
%....#.....#...%
%.....#....#...%
%......####....%
%..............%
%..............%
%..............%
%!!............%
%*!..####......%
%!!.#....#.....%
%*!.#.....#....%
%*!#...@.......%
%%%%%%%%%%%%%%%%