%%%%%%%%%%%%%%%%
%....#$!!!!!...%
%....#$....##..%
%..#..#.....!!!%
%!**..!#.......%
%!!!!!.##!!#**#%
%...#$.......#$%
%...$#$.....#$.%
%...$#$....#$..%
%!!!.$#...#$...%
%........#$....%
%.$$##!!!$#$!#!%
%.##$$.@.......%
%%%%%%%%%%%%%%%%