%%%%%%%%%%%%%%%%
%!***##!**!*#..%
%.##&......#...%
%..##.....#&...%
%...###....##..%
%....&##.....#.%
%!!!**!!!!!!#!!%
%!!###!!!!***.!%
%..&...........%
%....#!!#.****!%
%..!*....##....%
%!!!#......#...%
%**#...@.....&.%
%%%%%%%%%%%%%%%%