%%%%%%%%%%%%%%%%
%....#$!!!!!...%
%....#$....##..%
%..#??.??...!!!%
%!**..!#.......%
%!!!!!.##!!#**#%
%..?#$.......#$%
%.?.$#$.....#$?%
%?..$#$....#$..%
%!!!.$#...#$...%
%........#$....%
%.$$##!!!$#$!#!%
%.##$$.@.......%
%%%%%%%%%%%%%%%%