%%%%%%%%%%%%%%%%
%!**!##!**!*#..%
%.##.......#...%
%..##.....#....%
%...###....##..%
%.....##.....#.%
%!!!**!!!!!!#!!%
%!!###!!!!*#**!%
%--------------%
%....#!!#!!!**!%
%..!*..&.##....%
%!!!#......#...%
%**#...@.......%
%%%%%%%%%%%%%%%%