%%%%%%%%%%%%%%%%
%...........#..%
%..........#...%
%..........#...%
%..########....%
%..............%
%..............%
%..............%
%..............%
%....#######...%
%...#..........%
%...#..........%
%..#...@.......%
%%%%%%%%%%%%%%%%