%%%%%%%%%%%%%%%%
%...........#..%
%....#.....#...%
%.....#....#...%
%......####....%
%..............%
%!!!**!!!!!!!!!%
%!!!!!!!!!****!%
%..............%
%....####......%
%...#....#.....%
%...#.....#....%
%..#...@.......%
%%%%%%%%%%%%%%%%