%%%%%%%%%%%%%%%%
%!**!##!**!*#..%
%.##.......#...%
%..##.....#....%
%...###....##..%
%.....##.....#.%
%!!!**!!!!!!#!!%
%!!###!!!!****!%
%..............%
%....#!!#!****!%
%..!*..&.##....%
%!!!#......#...%
%**#...@.......%
%%%%%%%%%%%%%%%%