%%%%%%%%%%%%%%%%
%....#......#..%
%....#.....#...%
%..#..#....#...%
%....#.........%
%..............%
%............##%
%...........#..%
%..........#...%
%.........#$...%
%..$#$...#$....%
%..$#....$#$...%
%.##$..@.......%
%%%%%%%%%%%%%%%%