%%%%%%%%%%%%%%%%
%!8*!##!**!*#..%
%.##.......#...%
%..##.....#....%
%...###....##..%
%.....##.....#.%
%!!!**!!!!!!#!!%
%!!###!!!!****!%
%..............%
%....#!!#!8***!%
%..!*..&.##....%
%!!!#.99...#...%
%8*#...@...$$$.%
%%%%%%%%%%%%%%%%