++++++++++++++++
+------------#-+
+-------#-#-#--+
+-2-------#----+
+--------#-----+
+----------#---+
+-2------------+
+-22-----------+
+---2--#-------+
+-2##---##-----+
+----##---#----+
+-----------#--+
+------@-----#-+
++++++++++++++++