%%%%%%%%%%%%%%%%
%....#......#..%
%....#.....#...%
%..#..#....#...%
%....#.........%
%..............%
%............##%
%...........#..%
%!!........#...%
%*!.......#....%
%!!.#....#.....%
%*!.#.....#....%
%*!#...@.......%
%%%%%%%%%%%%%%%%