%%%%%%%%%%%%%%%%
%....#$!!!!!...%
%....#$&...##..%
%.&#..#.....!!!%
%!**..!#.......%
%!!!!!.##!!#**#%
%...#$&.....&#$%
%...$#$.....#$.%
%...$#$....#$..%
%!!!&$#...#$...%
%........#$&...%
%.$$##!!!$#$!#!%
%.##$$.@.......%
%%%%%%%%%%%%%%%%