%%%%%%%%%%%%%%%%
%!**!##!**!*#..%
%.##.......#...%
%..##.....#....%
%...###....##..%
%.....##.....#.%
%!!!**!!!!!!#!!%
%!!###!!!!*#**!%
%..............%
%....#!!#!!!**!%
%..!*....##....%
%!!!#......#...%
%**#...@.......%
%%%%%%%%%%%%%%%%