%%%%%%%%%%%%%%%%
%!***##!**!*#..%
%.##.......#...%
%..##.....#....%
%...###....##..%
%.....##.....#.%
%!!!??****!!#!!%
%!!###!!!!!**.!%
%..............%
%....#!!#.****!%
%..!*....##....%
%!!!#......#...%
%**#...@.......%
%%%%%%%%%%%%%%%%